111111111111
10P00C000E01
111111111111
