1111111111111111
100P0000X000C0E1
1111111111111111
