1111111111
1000000001
10E00C0001
1000000C01
10X0000C01
10000P0001
10C00CCC01
10000C0001
10C000C001
1111111111
